XXXXXXXXXXXXXXXXXX
XDDDDDDDDDDDDDDDDX
XDXXXXXXXXXXXXXXDX
XDX            XDX
XDX            XDX
XDX            XDX
XDX            XDX
XDXXXXXXXXXXXXXXDX
XDDDDDDDDDDDDDDDDX
XXXXXXXXXXXXXXXXXX