XXXXXXXXXXXXXXXXXX
XXXD        XXXXXX
XDXXXX      XXXXXX
X           XXXXXX
X               DX
XXXXXXXXXXXXXXXXXX
XXXXXXXXXXXXXXXXXX