XXXXXXXXXXXXXXXXXX
XXXXXX      XXXXXX
XXX     DD     XXX
XX     DDDD     XX
XXX     DD     XXX
XXXXXX      XXXXXX
XXXXXXXXXXXXXXXXXX